#############
#RRR        #
#  R        #
#  R        #
#  RRRRRTT  #
#     TR    #
#      R    #
#      R   T#
#      RRRRR#
#############