#############
#RRR        #
#  R        #
#  R        #
#  RRRRRTT  #
#     TR    #
#      RRRR #
#      R   T#
#      RRRRR#
#############