##################
#IP              #
# P              #
# P              #
# PPPPPPT        #
#     TP         #
#      P         #
#      P T       #
#      PPPPPPPP  #
#             P  #
#             PR #
#                #
##################