##################
#                #
#                #
#                #
#   PPPPT        #
#   P TP         #
#   P  P         #
#   P  P T       #
#   P  PPPPPPPPP #
#   P          P #
#   I          R #
#                #
##################